NO ./path_to_the_north_texture
SO ./path_to_the_south_texture
WE ./path_to_the_west_texture
EA ./path_to_the_east_texture

F 220,100,0
C 225,30,0

        1111111111111111111111111    111
        1000000000110000000000001    101
        1011000001110000000000001    111
        1001000000000000000000001
111111111011000001110000000000001
100000000011000001110111111111111
11110111111111N11100000010001
11110101111111011101010010001
11000000110101011100000000001
10000111111111111111111111111
11111111111111111111111111111