    NO ./textures/wall_1.xpm
    SO       ./textures/wall_2.xpm
    WE ./textures/wall_3.xpm       
    EA ./textures/wall_4.xpm
    F      0,126,100       
    C  120,128,100       

11111
00011
 
        1111111111111111111111111111
        1000000000001100000000000001
        1011000001110000000000001111
        1001000000000000000000001   
111111111011000001110000000000001   
100000000000000001110111111111111   
11110111111111N11000000010001       
1111010111111101110101001000X
11000000110101011100000000001
10000111111111111111111111111
11111111111111111111111111111